

Albert Hammond - It Never Rains In Southern California

Andreas Vollenweider - Trilogy 

Cafe Del Mar - Alexander Borodin / Choral Dance 

Sangit Om - Wind 

The Weeknd - Blinding Lights. 

Dua Lipa - Physical. 

Jonas Brothers - Sucker. 

Dua Lipa - Physical. 

The Black Eyed Peas & J Balvin - RITMO (Bad Boys For Life). 

Lil Nas X feat. Billy Ray Cyrus - Old Town Road (Remix). 

Макс Барских - Лей, не жалей. 

Jonas Brothers - Sucker. 

Ariana Grande - Side to Side (feat. Nicki Minaj). 

The Weeknd - Blinding Lights. 

Phil Collins - Against All Odds. 

Slider & Magnit - Right Back. 

Alcazar - Physical. 

Die Fantastischen Vier   MfG

Маршал Александр - Ливень. 

Superheroes - THE SCRIPT. 

THE WEEKND - Blinding Lights. 

EXAMPLE - KIDS AGAIN. 

Moguai feat. Tom Cane - You'll See Me. 

НЕСЧАСТНЫЙ СЛУЧАЙ - ИЗ КФ ГЕНЕРАЛЫ ПЕСЧАНЫХ КАРЬЕР. 

Jason Aldean - Lights Come On. 

Пропаганда - До Луны на метро (DJ Pomeha Electro Radio Remix). 

LastEden - Sunrise (Long Mix). 

Alexander V. Mogilco feat. Jama - MC . 

Enigma - Page Of Cups. 

Goloka - Sleepless In Warsaw . 

Berlin Project - Vuelve Mi Amor. 

Framewerk - U Used To Hold Me (Framewerk Rewerk). 

Roger Shah presents Sunlounger feat. Zara Taylor - Feels Like Heaven. 

Inna - Amazing (Lost Exile Remix). 

Stefre Roland - The Night (Original Mix). 

Stefre Roland, Dj Quba - Come To Night (Original Mix)). 

Magic Ear - Eternal Spring. 

JERMAINE JACKSON - dynamite. 

Tony Igy  - Astronomia  . 

Ed Sheeran - I See Fire (Dmitriy Rs & Dj Alexander Holsten Remix). 

Queen - I Want It All. 

Bananarama - Cruel Summer. 